4 4 4 4 4 4 4 4 4 4 4 4 4 4 4 4 4 4 4 4 4 4 4 4 4 4 4 4 4 4 4 4 4 4 4 4 4 4 4 4 4 4 4 4 4 4 4 4 4 4 4 4 4 4 4 4 4 4 4 4 4 4 4 4 4 4 4 4 4 4 4 4 4 4 4 4 4 4 4 4 4 4 4 4 4 4 4 4 4 4 4 4 4 4 4 4 4 4 4 4 
4 4 4 4 4 4 4 4 4 4 4 4 4 4 4 4 4 4 4 4 4 4 4 4 4 4 4 4 4 4 4 4 4 4 4 4 4 4 4 4 4 4 4 4 4 4 4 4 4 4 4 4 4 4 4 4 4 4 4 4 4 4 4 4 4 4 4 4 4 4 4 4 4 4 4 4 4 4 4 4 4 4 4 4 4 4 4 4 4 4 4 4 4 4 4 4 4 4 4 4 
4 4 4 4 4 4 4 4 4 4 4 4 4 4 4 4 4 4 4 4 4 4 4 4 4 4 4 4 4 4 4 4 4 4 4 4 4 4 4 4 4 4 4 4 4 4 4 4 4 4 4 4 4 4 4 4 4 4 4 4 4 4 4 4 4 4 4 4 4 4 4 4 4 4 4 4 4 4 4 4 4 4 4 4 4 4 4 4 4 4 4 4 4 4 4 4 4 4 4 4 
4 4 4 4 4 4 4 4 4 4 4 4 4 4 4 4 4 4 4 4 4 4 4 4 4 4 4 4 4 4 4 4 4 4 4 4 4 4 4 4 4 4 4 4 4 4 4 4 4 4 4 4 4 4 4 4 4 4 4 4 4 4 4 4 4 4 4 4 4 4 4 4 4 4 4 4 4 4 4 4 4 4 4 4 4 4 4 4 4 4 4 4 4 4 4 4 4 4 4 4 
4 4 4 4 4 4 4 4 4 4 4 4 4 4 4 4 4 4 4 4 4 4 4 4 4 4 4 4 4 4 4 4 4 4 4 4 4 4 4 4 4 4 4 4 4 4 4 4 4 4 4 4 4 4 4 4 4 4 4 4 4 4 4 4 4 4 4 4 4 4 4 4 4 4 4 4 4 4 4 4 4 4 4 4 4 4 4 4 4 4 4 4 4 4 4 4 4 4 4 4 
4 4 4 4 4 4 4 3 3 3 3 3 3 3 3 3 3 3 3 3 3 3 3 3 3 3 3 3 3 3 3 3 3 3 3 3 3 3 3 3 3 3 3 3 3 3 3 3 3 3 3 3 3 3 3 3 3 3 3 3 3 3 3 3 3 3 3 3 3 3 3 3 3 3 3 3 3 3 3 3 3 3 3 3 3 3 3 3 3 3 3 3 3 4 4 4 4 4 4 4 
4 4 4 4 4 4 4 3 4 4 4 4 4 4 4 4 4 4 4 4 4 4 4 4 4 4 4 4 4 4 4 4 4 4 4 4 4 4 4 4 4 4 4 4 4 4 4 4 4 4 4 4 4 4 4 4 4 4 4 4 4 4 4 4 4 4 4 4 4 4 4 4 4 4 3 2 2 2 2 2 3 4 4 4 4 4 4 4 4 4 4 4 3 4 4 4 4 4 4 4 
4 4 4 4 4 4 4 3 4 4 4 4 4 4 4 4 4 4 4 4 4 4 4 4 4 4 4 4 4 4 4 4 4 4 4 4 4 4 4 4 4 4 4 4 4 4 4 4 4 4 4 4 4 4 4 4 4 4 4 4 4 4 4 4 4 4 4 4 4 4 4 4 4 4 3 2 2 2 2 2 3 4 4 4 4 4 4 4 4 4 4 4 3 4 4 4 4 4 4 4 
4 4 4 4 4 4 4 3 4 4 1 1 1 1 1 1 1 1 1 1 4 4 4 4 4 4 4 4 4 4 4 4 4 4 4 4 4 4 4 4 4 4 4 4 4 4 4 4 4 4 4 4 4 4 4 4 4 4 4 4 4 4 4 4 4 4 4 4 4 4 4 4 4 4 3 2 2 2 2 2 3 4 4 4 4 4 4 4 4 4 4 4 3 4 4 4 4 4 4 4 
4 4 4 4 4 4 4 3 4 4 1 1 1 1 1 1 1 1 1 1 4 4 4 4 4 4 4 4 4 4 4 4 4 4 4 4 4 4 4 4 4 4 4 4 4 4 4 4 4 4 4 4 4 4 4 4 4 4 4 4 4 4 4 4 4 4 4 4 4 4 4 4 4 4 3 2 2 2 2 2 3 4 4 4 4 4 4 4 4 4 4 4 3 4 4 4 4 4 4 4 
4 4 4 4 4 4 4 3 4 4 1 1 1 1 1 1 1 1 1 1 4 4 4 4 4 4 4 4 4 4 4 4 4 4 4 4 4 4 4 4 4 4 4 4 4 4 4 4 4 4 4 4 4 4 4 4 4 4 4 4 4 4 4 4 4 4 4 4 4 4 4 4 4 4 3 2 2 2 2 2 3 4 4 4 4 4 4 4 4 4 4 4 3 4 4 4 4 4 4 4 
4 4 4 4 4 4 4 3 4 4 1 1 1 1 1 1 1 1 1 1 4 4 4 4 4 4 4 4 4 4 4 4 4 4 4 4 4 4 4 4 4 4 4 4 4 4 4 4 4 4 4 4 4 4 4 4 4 4 4 4 4 4 4 4 4 4 4 4 4 4 4 4 4 4 3 3 3 1 3 3 3 4 4 4 4 4 4 4 4 4 4 4 3 4 4 4 4 4 4 4 
4 4 4 4 4 4 4 3 4 4 1 1 1 1 1 1 1 1 1 1 4 4 4 4 4 4 4 4 4 4 4 4 4 4 4 4 4 4 4 4 4 4 4 4 4 4 4 4 4 4 4 4 4 4 4 4 4 4 0 0 8 10 10 10 8 0 0 4 4 4 4 4 4 4 4 4 11 1 11 4 4 4 4 4 4 4 4 4 4 4 4 4 3 4 4 4 4 4 4 4 
4 4 4 4 4 4 4 3 4 4 1 1 1 3 1 1 3 1 1 1 4 4 4 4 4 4 4 4 4 4 4 4 4 4 4 4 4 4 4 4 4 4 4 4 4 4 4 4 4 4 4 4 4 4 4 4 4 0 0 0 4 4 10 4 0 0 0 0 4 4 4 4 4 4 4 4 11 1 11 4 4 4 4 4 4 4 4 4 4 4 4 4 3 4 4 4 4 4 4 4 
4 4 4 4 4 4 4 3 4 4 4 4 4 4 1 1 4 4 4 4 4 4 4 4 4 4 4 4 4 4 4 4 4 4 4 4 4 4 4 4 4 4 4 4 4 4 3 3 3 3 3 3 3 4 4 4 4 0 0 4 4 4 4 4 4 0 0 0 4 4 4 4 4 4 4 4 4 1 4 4 4 4 4 4 4 4 4 4 4 4 4 4 3 4 4 4 4 4 4 4 
4 4 4 4 4 4 4 3 4 4 4 4 4 4 1 1 4 4 4 4 4 4 4 4 4 4 4 4 4 4 4 4 4 4 4 4 4 4 4 4 4 4 4 4 4 4 3 2 2 2 2 2 3 4 4 4 4 0 4 4 7 6 6 7 4 4 0 0 4 4 4 4 4 4 4 4 4 1 4 4 4 4 4 4 4 4 4 4 4 4 4 4 3 4 4 4 4 4 4 4 
4 4 4 4 4 4 4 3 4 4 4 4 4 4 5 5 4 4 4 4 4 4 4 4 4 4 4 4 4 4 4 4 4 4 4 4 4 4 4 4 4 4 4 4 4 4 3 2 2 2 2 2 3 4 4 4 4 4 4 4 6 6 6 6 4 4 4 4 4 4 4 4 4 4 4 4 4 1 4 4 4 4 4 4 4 4 4 4 4 4 4 4 3 4 4 4 4 4 4 4 
4 4 4 4 4 4 4 3 4 4 4 4 4 4 1 1 4 4 4 4 4 4 4 4 4 4 4 4 4 4 4 4 4 4 4 4 4 4 4 4 4 4 4 4 4 4 3 2 2 2 2 2 3 4 4 4 4 4 4 4 6 6 6 6 4 4 4 4 4 4 4 4 4 1 1 1 1 1 4 4 4 4 4 4 4 4 4 4 4 4 4 4 3 4 4 4 4 4 4 4 
4 4 4 4 4 4 4 3 4 4 4 4 4 4 6 6 4 4 4 4 4 4 4 4 4 4 4 4 4 4 4 4 4 4 4 4 4 4 4 4 4 4 4 4 4 4 3 3 3 2 3 3 3 4 4 4 4 4 4 4 7 6 6 7 4 4 4 4 4 8 4 4 4 1 4 4 4 4 4 4 4 4 4 4 4 4 4 4 4 4 4 4 3 4 4 4 4 4 4 4 
4 4 4 4 4 4 4 3 4 4 4 4 4 4 1 1 4 4 4 4 4 4 4 4 4 4 4 4 4 4 4 4 4 4 4 4 4 4 4 4 4 4 4 4 6 6 4 1 0 1 0 1 4 5 5 4 4 4 4 1 1 1 1 1 1 4 4 8 8 8 4 4 4 1 4 4 4 4 4 4 0 0 4 4 4 4 4 4 4 4 4 4 3 4 4 4 4 4 4 4 
4 4 4 4 4 4 4 3 4 4 4 4 4 4 6 6 4 4 4 4 4 4 4 4 4 4 4 4 4 4 4 4 4 4 4 4 4 4 4 4 4 4 4 6 6 7 4 0 1 0 1 0 4 5 5 5 4 4 4 1 1 1 1 1 1 4 4 8 8 8 4 4 4 1 4 4 4 4 4 4 4 4 4 4 4 4 4 4 4 4 4 4 3 4 4 4 4 4 4 4 
4 4 4 4 4 4 4 3 4 4 4 4 4 4 1 1 4 4 4 4 4 4 4 4 4 4 4 4 4 4 4 4 4 4 4 4 4 4 4 4 4 4 4 6 6 7 4 1 0 1 0 1 4 5 5 5 4 4 4 4 1 1 1 1 4 4 4 8 8 8 4 4 4 1 1 1 1 1 1 1 4 4 4 4 4 4 4 4 4 4 4 4 3 4 4 4 4 4 4 4 
4 4 4 4 4 4 4 3 4 4 4 4 4 4 5 5 4 4 4 4 4 4 4 4 4 4 4 4 4 4 4 4 4 4 4 4 4 4 4 4 4 4 4 4 6 6 4 0 1 0 1 0 4 5 5 4 4 4 4 4 1 1 1 1 4 4 4 8 8 8 4 4 4 4 4 4 4 4 4 1 4 4 4 4 4 4 4 4 4 4 4 4 3 4 4 4 4 4 4 4 
4 4 4 4 4 4 4 3 4 4 4 4 4 4 1 1 4 4 4 4 4 4 4 4 4 4 4 4 4 4 4 3 3 3 3 3 3 3 3 3 3 3 3 3 4 4 4 1 0 1 0 1 4 4 4 4 4 4 4 4 4 1 1 4 4 4 4 4 4 4 4 4 4 4 4 0 4 4 4 1 0 4 4 4 4 4 4 4 4 4 4 4 3 4 4 4 4 4 4 4 
4 4 4 4 4 4 4 3 4 4 4 4 4 4 1 1 4 4 4 4 4 4 4 4 4 4 4 4 4 4 4 3 6 6 6 6 6 6 6 1 5 5 5 3 4 4 4 4 3 1 3 4 4 4 4 4 4 4 4 4 4 1 1 4 4 4 4 4 4 4 4 4 4 4 0 0 4 4 4 1 0 4 4 4 4 4 4 4 4 4 4 4 3 4 4 4 4 4 4 4 
4 4 4 4 4 4 4 3 4 3 1 1 1 1 1 1 1 1 1 1 1 1 3 4 4 4 4 4 4 3 3 3 6 3 3 3 3 3 3 3 3 3 5 3 4 4 4 4 3 1 3 4 6 6 6 4 4 4 4 4 4 1 1 4 4 4 4 4 6 6 6 4 4 0 4 4 4 1 1 1 0 4 4 4 4 4 4 4 4 4 4 4 3 4 4 4 4 4 4 4 
4 4 4 4 4 4 4 3 4 3 1 1 1 1 1 1 1 1 1 1 1 1 3 4 4 4 4 4 4 3 3 3 6 3 4 4 4 4 4 4 4 3 5 3 4 4 4 4 3 1 3 4 6 6 6 4 4 4 4 4 4 1 1 4 4 4 4 4 6 6 6 4 4 4 4 4 4 1 4 4 4 4 4 4 4 4 4 4 4 4 4 4 3 4 4 4 4 4 4 4 
4 4 4 4 4 4 4 3 4 3 1 1 3 4 4 4 4 4 4 3 1 1 3 4 4 1 1 1 1 1 1 1 1 5 5 5 3 4 4 4 4 3 5 3 4 4 4 4 3 1 3 4 6 6 6 4 9 9 8 10 11 1 1 11 10 8 4 4 6 6 6 4 4 4 4 4 4 1 4 4 4 4 4 4 4 4 4 4 4 4 4 4 3 4 4 4 4 4 4 4 
4 4 4 4 4 4 4 3 4 3 1 1 3 4 8 4 8 4 4 3 1 1 1 1 1 1 1 3 3 3 3 3 3 3 3 5 3 4 4 4 4 3 5 3 4 4 1 1 1 1 4 4 4 4 4 4 9 8 8 11 4 1 1 4 11 8 8 4 4 4 4 4 4 4 4 4 4 1 4 4 4 4 4 4 4 4 4 4 4 4 4 4 3 4 4 4 4 4 4 4 
4 4 4 4 4 4 4 3 4 3 1 1 3 4 8 8 8 8 4 3 1 1 1 1 1 1 1 3 4 4 4 4 4 4 3 5 3 4 4 4 4 3 5 3 4 4 1 1 1 1 1 1 1 1 1 1 1 1 1 1 1 1 1 1 1 1 1 1 1 1 1 1 1 1 1 1 1 1 1 1 1 4 4 4 4 4 4 4 4 4 4 4 3 4 4 4 4 4 4 4 
4 4 4 4 4 4 4 3 4 3 1 1 3 4 4 8 8 4 4 8 8 8 1 3 3 3 3 3 4 4 4 3 3 3 3 5 3 3 3 4 4 3 1 3 3 3 1 1 1 1 3 4 4 4 4 4 9 8 8 11 4 1 1 4 11 8 8 4 4 4 4 4 4 4 4 4 4 4 4 1 1 4 4 4 4 4 4 4 4 4 4 4 3 4 4 4 4 4 4 4 
4 4 4 4 4 4 4 3 4 3 1 1 3 3 3 4 8 8 8 8 8 8 6 4 4 4 4 4 0 0 4 3 0 0 0 0 0 0 3 4 4 3 1 1 1 1 1 1 1 1 3 4 5 5 5 4 9 9 8 10 11 1 1 11 10 8 4 4 5 5 5 4 4 4 4 4 4 4 4 4 1 4 4 4 4 4 4 4 4 4 4 4 3 4 4 4 4 4 4 4 
4 4 4 4 4 4 4 3 4 1 1 1 1 1 3 3 3 3 3 3 8 8 6 4 4 4 4 4 0 0 4 3 5 3 3 3 3 6 3 4 4 3 3 3 3 3 3 3 3 3 3 4 5 5 5 4 4 4 4 4 4 1 1 4 4 4 4 4 5 5 5 4 4 4 4 4 4 4 4 4 1 4 4 4 4 4 4 4 4 4 4 4 3 4 4 4 4 4 4 4 
4 4 4 4 4 4 4 3 4 1 4 1 1 1 1 1 1 1 1 3 8 8 6 4 4 0 0 0 4 4 4 3 0 3 0 0 3 0 3 4 4 4 4 4 4 4 4 4 4 4 4 4 5 5 5 4 4 4 4 4 4 1 1 4 4 4 4 4 5 5 5 4 4 4 4 4 4 4 4 4 1 4 4 4 4 4 4 4 4 4 4 4 3 4 4 4 4 4 4 4 
4 4 4 4 4 4 4 3 4 1 1 4 1 4 4 4 4 1 1 3 8 8 1 4 4 4 4 4 4 4 4 3 0 3 6 0 3 0 3 4 4 4 4 4 4 4 4 4 4 4 4 4 4 4 4 4 4 4 4 4 4 1 1 4 4 4 4 4 4 4 4 4 4 4 4 4 4 4 4 4 1 4 4 4 4 4 4 4 4 4 4 4 3 4 4 4 4 4 4 4 
4 4 4 4 4 4 4 3 4 1 4 1 1 4 11 11 4 1 1 3 4 4 1 1 1 1 5 4 0 4 4 3 6 11 6 3 11 5 3 4 4 4 4 4 4 4 4 4 4 4 4 4 4 4 4 4 4 4 4 4 4 1 1 4 4 4 4 4 4 4 4 4 4 4 4 4 4 4 4 4 1 4 4 4 4 4 4 4 4 4 4 4 3 4 4 4 4 4 4 4 
4 4 4 4 4 4 4 3 4 1 1 4 1 10 10 10 10 1 1 3 4 4 4 4 4 4 5 4 4 4 4 3 0 3 0 0 3 0 3 4 4 4 4 4 4 4 4 4 4 4 4 4 4 4 4 4 4 4 4 4 4 1 1 4 4 4 4 4 4 4 4 4 4 4 4 4 4 4 4 4 1 4 4 4 4 4 4 4 4 4 4 4 3 4 4 4 4 4 4 4 
4 4 4 4 4 4 4 3 4 1 1 1 1 1 6 6 1 1 1 3 4 4 4 4 4 4 5 4 4 4 4 3 0 3 3 0 3 0 3 4 4 4 4 4 4 0 0 0 0 0 0 4 4 4 4 4 4 4 4 4 4 1 1 4 4 4 4 4 4 4 4 4 4 4 4 4 4 4 4 4 1 4 4 4 4 4 4 4 4 4 4 4 3 4 4 4 4 4 4 4 
4 4 4 4 4 4 4 3 10 7 4 4 1 10 11 11 10 1 3 3 4 4 4 4 1 1 1 10 1 4 4 3 5 3 0 5 3 6 3 4 4 4 4 4 4 0 4 4 4 0 0 4 4 4 4 4 4 4 4 4 1 1 1 1 4 4 4 4 4 4 4 4 4 4 4 4 4 4 4 4 1 4 4 4 4 4 4 4 4 4 4 4 3 4 4 4 4 4 4 4 
4 4 4 4 4 4 4 3 7 10 7 10 1 1 5 5 1 1 3 4 4 4 4 4 1 1 8 1 1 4 4 3 0 3 0 3 3 0 3 4 4 4 4 4 4 0 4 4 4 0 0 4 4 4 4 4 4 4 4 4 1 1 1 1 4 4 4 4 4 4 4 4 4 4 4 4 4 4 4 4 1 4 4 4 4 4 4 4 4 4 4 4 3 4 4 4 4 4 4 4 
4 4 4 4 4 4 4 3 3 3 3 3 3 3 3 3 3 3 3 4 4 4 4 4 1 11 1 1 1 4 4 3 0 3 6 0 0 5 3 4 4 4 4 4 4 0 0 0 0 0 0 4 4 4 4 4 4 4 4 1 1 1 1 1 1 4 4 4 4 4 4 4 4 4 4 4 4 4 4 0 0 0 0 0 4 4 4 4 4 4 4 4 3 4 4 4 4 4 4 4 
4 4 4 4 4 4 4 3 4 4 4 4 4 4 4 4 4 4 4 4 4 4 4 4 1 1 1 1 1 4 4 3 6 3 3 3 3 0 3 4 4 4 4 4 4 4 4 4 4 4 4 4 4 4 4 4 4 4 4 1 1 1 1 1 1 4 4 4 4 4 4 4 4 4 4 4 4 4 0 0 0 0 0 0 4 4 4 4 4 4 4 4 3 4 4 4 4 4 4 4 
4 4 4 4 4 4 4 3 4 4 4 4 4 4 4 4 4 4 4 4 4 4 4 4 4 4 4 4 4 4 4 3 0 0 5 6 0 0 3 4 4 4 4 4 4 4 4 4 4 4 4 4 4 4 4 4 4 4 4 4 5 5 5 5 4 4 4 4 4 4 4 4 4 4 4 4 4 0 0 0 10 0 10 0 0 4 4 4 4 4 4 4 3 4 4 4 4 4 4 4 
4 4 4 4 4 4 4 3 4 4 4 4 4 4 4 4 4 4 4 4 4 4 4 4 4 4 4 4 4 4 4 3 3 3 3 3 3 3 3 4 4 4 4 4 4 4 4 4 4 4 4 4 4 4 4 4 4 4 4 4 5 5 5 5 4 4 4 4 4 4 4 4 4 4 4 4 4 0 0 10 0 10 0 0 0 4 4 4 4 4 4 4 3 4 4 4 4 4 4 4 
4 4 4 4 4 4 4 3 4 4 4 4 4 4 4 4 4 4 4 4 4 4 4 4 4 4 4 4 4 4 4 4 4 4 4 4 4 4 4 4 4 4 4 4 4 4 4 4 4 0 0 4 4 4 4 4 4 4 4 4 5 5 5 5 4 4 4 4 4 1 1 1 1 1 1 1 1 0 0 0 0 0 0 0 0 4 4 4 4 4 4 4 3 4 4 4 4 4 4 4 
4 4 4 4 4 4 4 3 4 4 4 4 4 4 4 4 4 4 4 4 4 4 4 4 4 4 4 4 4 4 4 4 4 4 4 4 4 4 4 4 4 4 4 4 4 4 4 4 4 0 0 4 4 4 4 4 4 4 4 4 5 5 5 5 4 4 4 4 4 1 1 1 1 1 1 1 1 0 0 0 0 0 0 0 0 4 4 4 4 4 4 4 3 4 4 4 4 4 4 4 
4 4 4 4 4 4 4 3 4 4 4 4 4 4 4 4 4 4 4 4 4 4 4 4 4 4 4 4 4 4 4 4 4 4 4 4 4 4 4 4 4 4 4 4 0 0 0 0 4 4 4 4 4 4 4 4 4 4 4 4 11 1 1 11 4 4 4 0 0 1 1 4 4 4 4 4 4 4 4 4 4 4 4 4 4 4 4 4 4 4 4 4 3 4 4 4 4 4 4 4 
4 4 4 4 4 4 4 3 4 4 4 4 4 4 4 4 4 4 4 4 4 4 4 4 4 4 4 4 4 4 4 4 4 4 4 4 4 4 4 4 4 4 4 4 0 0 0 0 4 4 4 4 4 4 4 4 4 4 4 11 11 1 1 11 11 4 4 0 1 1 1 4 4 4 4 4 4 4 4 4 4 4 4 4 4 4 4 4 4 4 4 4 3 4 4 4 4 4 4 4 
4 4 4 4 4 4 4 3 4 4 4 4 4 4 4 4 4 4 4 4 4 4 4 4 4 4 4 4 4 4 4 4 4 4 3 3 3 3 3 4 4 4 4 4 0 0 0 0 0 1 1 1 1 1 1 1 4 4 4 4 4 1 1 4 4 4 1 1 1 1 4 4 4 4 4 4 4 4 4 4 4 4 4 4 4 4 4 4 4 4 4 4 3 4 4 4 4 4 4 4 
4 4 4 4 4 4 4 3 4 4 4 4 4 4 4 4 4 4 4 4 4 4 4 4 4 4 4 4 4 4 4 4 4 4 3 2 2 2 2 6 6 6 4 4 0 4 0 0 0 4 4 4 4 4 4 1 4 4 4 4 4 1 1 1 1 1 1 1 1 0 4 4 4 4 4 4 4 4 4 4 4 4 4 4 4 4 4 4 4 4 4 4 3 4 4 4 4 4 4 4 
4 4 4 4 4 4 4 3 4 4 4 4 4 4 4 4 4 4 4 4 4 4 4 4 4 4 4 4 4 4 4 4 4 4 3 2 2 2 2 7 7 6 4 4 0 7 4 0 0 4 4 4 4 4 4 1 4 4 4 4 4 1 1 1 1 1 1 1 0 0 4 4 4 4 4 4 4 4 4 4 4 4 4 4 4 4 4 4 4 4 4 4 3 4 4 4 4 4 4 4 
4 4 4 4 4 4 4 3 4 4 4 4 4 4 4 4 4 4 4 4 4 4 4 4 4 4 4 4 4 4 4 4 4 4 3 2 2 2 2 0 0 0 0 0 0 4 0 0 4 0 0 4 4 4 4 1 1 1 1 1 1 1 1 4 4 4 4 4 4 4 4 4 4 4 4 4 4 4 4 4 4 4 4 4 4 4 4 4 4 4 4 4 3 4 4 4 4 4 4 4 
4 4 4 4 4 4 4 3 4 4 4 4 4 4 4 4 4 4 4 4 4 4 4 4 4 4 4 4 4 4 4 4 4 4 3 2 2 2 2 7 7 6 4 4 0 0 0 0 4 0 0 4 4 4 4 4 4 4 4 4 4 4 4 4 4 4 4 4 4 4 4 4 4 4 4 4 4 4 4 4 4 4 4 4 4 4 4 4 4 4 4 4 3 4 4 4 4 4 4 4 
4 4 4 4 4 4 4 3 3 3 3 3 3 3 3 3 3 3 3 3 3 3 3 3 3 3 3 3 3 3 3 3 3 3 3 2 2 2 2 6 6 6 4 4 4 4 4 4 4 4 4 4 4 4 4 4 4 4 4 4 4 4 4 4 4 4 4 4 4 4 4 4 4 4 4 4 4 4 4 4 4 4 4 4 4 4 4 4 4 4 4 4 3 4 4 4 4 4 4 4 
4 4 4 4 4 4 4 3 4 4 4 4 4 4 4 4 4 4 4 4 4 4 4 4 4 4 4 4 4 4 4 4 4 4 3 3 3 3 3 3 4 4 4 4 4 4 4 4 4 4 4 4 4 4 4 4 4 4 4 4 4 4 4 4 4 4 4 4 4 4 4 4 4 4 4 4 4 4 4 4 4 4 4 4 4 4 4 4 4 4 4 4 3 4 4 4 4 4 4 4 
4 4 4 4 4 4 4 3 4 4 4 4 4 4 4 4 4 4 4 4 4 4 4 4 4 4 4 4 4 4 4 4 4 4 4 4 4 4 4 4 4 4 4 4 4 4 4 4 4 4 4 4 4 4 4 4 4 4 4 4 4 4 4 4 4 4 4 4 4 4 4 4 4 4 4 4 4 4 4 4 4 4 4 4 4 4 4 4 4 4 4 4 3 4 4 4 4 4 4 4 
4 4 4 4 4 4 4 3 4 11 11 11 8 8 8 8 11 11 11 11 4 4 4 4 4 4 4 4 4 4 4 4 4 4 4 4 4 4 4 4 4 4 4 4 4 4 4 4 4 4 4 4 4 4 4 4 4 4 4 4 4 4 4 4 4 4 4 4 4 4 4 4 4 4 4 4 4 4 4 4 4 4 4 4 4 4 4 4 4 4 4 4 3 4 4 4 4 4 4 4 
4 4 4 4 4 4 4 3 4 8 1 1 1 1 1 1 1 1 1 8 4 4 4 4 4 4 4 4 4 4 4 4 4 4 4 4 4 4 4 4 4 4 4 4 4 4 4 4 4 4 4 4 4 4 4 4 4 4 4 4 4 4 4 4 4 4 4 4 4 4 4 4 4 4 4 4 4 4 4 4 4 4 4 4 4 4 4 4 4 4 4 4 3 4 4 4 4 4 4 4 
4 4 4 4 4 4 4 3 4 8 1 1 6 1 1 1 5 1 1 8 4 4 4 4 4 4 4 4 4 4 4 4 4 4 4 4 4 4 4 3 3 3 3 3 3 3 3 3 3 3 4 4 4 4 4 4 4 4 4 4 4 4 4 4 4 4 4 4 4 4 4 4 4 4 4 4 4 4 4 4 4 4 4 4 4 4 4 4 4 4 4 4 3 4 4 4 4 4 4 4 
4 4 4 4 4 4 4 3 4 1 1 6 1 6 1 5 1 5 1 1 4 4 4 4 4 4 4 4 4 4 4 4 4 4 4 4 4 4 4 3 1 1 1 1 1 1 1 1 1 3 3 3 3 3 3 3 3 3 3 4 4 4 4 4 4 4 3 3 3 3 3 3 3 3 3 4 4 4 4 3 3 3 3 3 3 4 4 4 4 4 4 4 3 4 4 4 4 4 4 4 
4 4 4 4 4 4 4 3 4 1 6 1 1 1 5 1 1 1 5 1 4 4 4 4 4 4 4 4 4 4 4 4 4 4 4 4 4 4 4 3 1 1 1 1 0 1 1 1 1 1 6 6 1 5 1 1 1 1 3 4 4 3 3 3 3 3 3 1 1 1 6 1 1 1 3 4 4 4 4 3 1 1 6 1 3 4 4 4 4 4 4 4 3 4 4 4 4 4 4 4 
4 4 4 4 4 4 4 3 4 1 1 6 1 1 1 1 1 5 1 1 4 4 4 4 4 4 4 4 4 4 4 4 4 4 4 4 4 4 4 3 1 1 1 0 0 1 1 1 1 3 3 3 3 3 3 3 3 6 3 4 3 3 1 6 1 1 3 1 5 3 3 3 3 6 3 4 4 4 4 3 1 3 3 6 3 3 3 3 3 3 3 4 3 4 4 4 4 4 4 4 
4 4 4 4 4 4 4 3 4 1 1 1 6 1 1 1 5 1 1 1 4 4 4 4 4 4 4 4 4 4 4 4 4 4 4 4 4 4 4 3 1 1 1 1 0 1 1 1 1 3 4 4 3 6 1 5 1 1 3 4 3 1 1 3 3 1 3 3 1 3 4 4 3 1 3 4 3 3 3 3 5 3 3 6 1 5 1 1 1 1 3 4 3 4 4 4 4 4 4 4 
4 4 4 4 4 4 4 3 4 1 1 1 1 6 1 5 1 1 1 1 4 4 4 4 4 4 4 4 4 4 4 4 4 4 4 4 4 4 4 3 1 1 1 1 0 1 1 1 1 3 4 4 3 6 3 3 3 3 3 3 3 5 3 3 3 5 3 3 1 3 4 3 1 5 3 3 3 1 5 1 1 3 3 3 3 3 3 3 3 1 3 4 3 4 4 4 4 4 4 4 
4 4 4 4 4 4 4 3 4 8 1 1 1 1 6 1 1 1 1 8 4 4 4 4 4 4 4 4 4 4 4 4 4 4 4 4 4 4 4 3 1 1 1 0 0 0 1 1 1 3 4 4 3 1 6 1 1 1 5 1 1 1 3 4 3 1 6 1 6 3 4 3 6 1 1 6 1 1 3 3 3 3 4 4 4 4 4 4 4 1 3 4 3 4 4 4 4 4 4 4 
4 4 4 4 4 4 4 3 4 8 4 4 4 4 6 4 4 4 4 8 4 4 4 4 4 4 4 4 4 4 4 4 4 4 4 4 4 4 4 3 1 1 1 1 1 1 1 1 1 3 4 4 3 3 3 3 3 3 3 3 3 3 3 4 3 3 3 3 3 3 4 3 3 3 3 3 3 3 3 4 4 3 3 3 3 1 1 1 1 1 3 4 3 4 4 4 4 4 4 4 
4 4 4 4 4 4 4 3 4 4 4 4 4 3 6 3 4 4 4 4 4 4 4 4 4 4 4 4 4 4 4 4 4 4 4 4 4 4 4 3 3 3 3 3 3 3 3 3 3 3 4 4 4 4 4 4 4 4 4 4 4 4 4 4 4 4 4 4 4 4 4 4 4 4 4 4 4 4 4 4 3 2 0 0 2 1 0 4 0 0 3 4 3 4 4 4 4 4 4 4 
4 4 4 4 4 4 4 3 4 4 4 4 4 3 6 3 4 4 4 4 4 4 4 4 4 4 4 4 4 4 4 4 4 4 4 4 4 4 4 3 3 3 3 3 3 3 3 3 3 3 4 4 4 4 4 4 4 4 4 4 4 4 4 4 4 4 4 4 4 4 4 4 4 4 4 4 4 4 4 4 3 0 1 1 0 1 4 0 4 4 3 4 3 4 4 4 4 4 4 4 
4 4 4 4 4 4 4 3 4 4 4 4 4 3 6 3 4 4 4 4 4 4 4 4 4 4 4 4 4 4 4 4 4 4 4 4 4 4 4 3 1 1 1 1 1 1 1 1 1 3 4 4 4 4 4 4 4 4 4 4 4 4 4 4 4 4 4 4 4 4 4 4 4 4 4 4 4 4 4 4 3 2 0 0 2 1 1 1 1 1 3 4 3 4 4 4 4 4 4 4 
4 4 4 4 4 4 4 3 4 4 4 4 4 3 6 3 4 4 4 4 4 4 4 4 4 4 4 4 4 4 4 4 4 4 4 4 4 4 4 3 1 1 1 0 0 0 1 1 1 3 4 4 4 4 4 4 4 4 4 4 4 4 4 4 4 4 4 4 4 4 4 4 4 4 4 4 4 4 4 4 4 3 3 3 3 4 4 4 4 1 3 4 3 4 4 4 4 4 4 4 
4 4 4 4 4 4 4 3 4 4 4 4 4 3 6 3 4 4 4 4 4 4 4 4 4 4 4 4 4 4 4 4 4 4 4 4 4 4 4 3 1 1 1 1 1 0 1 1 1 3 3 3 3 3 3 3 3 3 3 3 3 3 3 3 3 3 3 3 3 3 3 3 3 3 3 3 3 3 3 3 3 3 3 3 3 3 3 3 3 1 3 4 3 4 4 4 4 4 4 4 
4 4 4 4 4 4 4 3 4 4 4 4 4 3 6 3 4 4 4 4 4 4 4 4 4 4 4 4 4 0 0 0 0 11 0 4 4 4 4 3 1 1 1 0 0 0 1 1 1 1 1 1 1 1 1 1 1 1 1 1 1 1 1 1 1 1 1 1 1 1 1 1 1 1 1 1 1 1 1 1 1 1 1 1 1 1 1 1 1 1 3 4 3 4 4 4 4 4 4 4 
4 4 4 4 4 4 4 3 4 4 4 4 4 3 6 3 4 4 4 4 4 4 4 4 4 4 4 4 4 11 11 0 11 11 0 0 4 4 4 3 1 1 1 0 1 1 1 1 1 3 3 3 3 3 3 3 3 1 4 4 11 4 11 0 11 0 4 4 4 4 10 10 10 4 4 10 10 10 0 4 10 10 4 4 4 4 4 4 4 1 3 4 3 4 4 4 4 4 4 4 
4 4 4 4 4 4 4 3 4 4 4 4 4 3 6 3 4 4 4 4 4 4 4 4 4 4 4 11 0 11 0 4 4 4 11 11 4 4 4 3 1 1 1 0 0 0 1 1 1 3 4 4 4 4 4 4 3 1 4 0 4 11 11 4 4 4 11 11 10 10 4 4 10 10 4 0 4 4 10 10 4 4 4 4 4 4 4 4 4 1 3 4 3 4 4 4 4 4 4 4 
4 4 4 4 4 4 4 3 4 4 4 4 4 3 6 3 4 4 4 4 4 4 4 4 4 4 4 4 4 4 4 4 4 4 4 4 4 4 4 3 1 1 1 1 1 1 1 1 1 3 4 4 4 4 4 4 3 1 1 1 1 1 1 1 1 1 1 1 1 1 1 1 1 1 1 1 1 1 1 1 1 1 1 1 1 1 1 1 1 1 3 4 3 4 4 4 4 4 4 4 
4 4 4 4 4 4 4 3 4 4 4 4 4 3 6 3 4 4 4 4 4 4 4 4 4 4 4 4 4 4 4 4 4 4 4 4 4 4 4 3 3 3 3 3 3 3 3 3 3 3 4 4 4 4 4 4 3 3 3 3 3 3 3 3 3 3 3 3 3 3 3 3 3 3 3 3 3 3 3 3 3 3 3 3 3 3 3 3 3 3 3 4 3 4 4 4 4 4 4 4 
4 4 4 4 4 4 4 3 4 4 4 4 4 3 6 3 4 4 4 4 4 4 4 4 4 4 4 3 3 3 3 3 3 3 3 3 4 4 4 3 3 3 3 3 3 3 3 3 3 3 4 4 4 4 4 4 4 4 4 4 4 4 4 4 4 4 4 4 4 4 4 4 4 4 4 4 4 4 4 4 4 4 4 4 4 4 4 4 4 4 4 4 3 4 4 4 4 4 4 4 
4 4 4 4 4 4 4 3 4 4 4 4 4 3 6 3 4 4 4 4 4 4 4 4 4 4 4 3 1 1 1 1 1 1 1 3 4 4 4 3 1 1 1 1 1 1 1 1 1 3 4 4 4 4 4 4 4 4 4 4 4 4 4 4 4 4 4 4 4 4 4 4 4 4 4 4 4 4 4 4 4 4 4 4 4 4 4 4 4 4 4 4 3 4 4 4 4 4 4 4 
4 4 4 4 4 4 4 3 4 4 4 4 4 3 6 3 4 4 4 4 4 4 4 4 4 4 4 3 1 1 1 1 1 1 1 3 4 4 4 3 1 1 1 0 0 0 1 1 1 3 4 4 4 4 4 4 4 4 4 4 4 4 4 4 4 4 4 4 4 4 4 4 4 4 4 4 4 4 4 4 4 4 4 4 4 4 4 4 4 4 4 4 3 4 4 4 4 4 4 4 
4 4 4 4 4 4 4 3 4 4 4 4 4 3 6 3 4 4 4 4 4 4 4 4 4 4 4 3 1 1 1 1 1 1 1 3 4 4 4 3 1 1 1 1 1 0 1 1 1 3 3 3 3 3 3 3 3 3 3 3 3 3 3 3 3 3 3 3 3 4 4 4 4 4 4 4 4 4 4 4 4 4 4 4 4 4 4 4 4 4 4 4 3 4 4 4 4 4 4 4 
4 4 4 4 4 4 4 3 4 4 4 3 3 3 6 3 3 3 3 3 4 4 4 4 4 4 4 3 1 1 1 1 1 1 1 3 4 4 4 3 1 1 1 0 0 0 1 1 1 1 1 1 1 1 1 1 1 1 1 1 1 1 1 1 1 1 1 1 3 4 4 4 4 4 4 4 4 4 4 4 4 4 4 4 4 4 4 4 4 4 4 4 3 4 4 4 4 4 4 4 
4 4 4 4 4 4 4 3 4 4 4 3 1 1 1 1 1 1 1 3 4 4 4 4 4 4 4 3 1 1 1 1 1 1 1 3 4 4 4 3 1 1 1 1 1 0 1 1 1 3 3 3 3 3 3 3 3 1 3 3 3 3 1 3 3 3 3 1 3 4 4 4 4 4 4 4 4 4 4 4 4 4 4 4 4 4 4 4 4 4 4 4 3 4 4 4 4 4 4 4 
4 4 4 4 4 4 4 3 4 4 4 3 3 3 5 3 6 3 3 3 4 4 4 4 4 4 4 3 1 1 1 1 1 1 1 3 4 4 4 3 1 1 1 0 0 0 1 1 1 3 4 4 4 4 4 7 3 1 3 7 4 3 1 3 7 4 3 1 3 4 4 4 4 4 4 4 4 4 4 4 4 4 4 4 4 4 4 4 4 4 4 4 4 4 4 4 4 4 4 4 
4 4 4 4 4 4 4 3 4 4 4 3 5 5 5 3 6 6 6 3 4 4 4 4 4 4 4 3 1 1 1 1 1 1 1 3 4 4 4 3 1 1 1 1 1 1 1 1 1 3 4 4 4 4 4 7 3 3 3 7 4 3 3 3 7 4 3 3 3 4 4 4 4 4 4 4 4 4 4 4 4 4 4 4 4 4 4 4 4 4 4 4 4 4 4 4 4 4 4 4 
4 4 4 4 4 4 4 3 4 4 4 3 5 5 5 3 6 6 6 3 4 4 4 4 4 4 4 3 3 3 1 3 1 3 3 3 4 4 4 3 3 3 3 3 3 3 3 3 3 3 4 4 4 4 4 4 4 4 4 4 4 4 4 4 4 4 4 4 4 4 4 4 4 4 4 4 4 4 4 4 4 4 4 4 4 4 4 4 4 4 4 4 4 4 4 4 4 4 4 4 
4 4 4 4 4 4 4 3 4 4 4 3 5 5 5 3 6 6 6 3 4 4 4 4 4 4 4 4 4 3 6 3 5 3 4 4 4 4 4 4 4 4 4 4 4 4 4 4 4 4 4 4 4 4 4 4 4 4 4 4 4 4 4 4 4 4 4 4 4 4 4 4 4 4 4 4 4 4 4 4 4 4 4 4 4 4 4 4 4 4 4 4 4 4 4 4 4 4 4 4 
4 4 4 4 4 4 4 3 4 4 4 3 5 5 5 3 6 6 6 3 4 4 4 4 4 4 4 4 4 3 6 3 5 3 4 4 4 4 4 4 4 4 4 4 4 4 4 4 4 4 4 4 4 4 4 4 4 4 4 4 4 4 4 4 4 4 4 4 4 4 4 4 4 4 4 4 4 4 4 4 4 4 4 4 4 4 4 4 4 4 4 4 4 4 4 4 4 4 4 4 
4 4 4 4 4 4 4 3 4 4 4 3 5 5 3 4 3 6 6 3 4 4 4 4 4 4 4 4 4 3 6 3 5 3 4 4 4 4 4 4 4 4 4 4 4 4 4 4 4 4 4 4 4 4 4 4 4 4 4 4 4 4 4 4 4 4 4 4 4 4 4 4 4 4 4 4 4 4 4 4 4 4 4 4 4 4 4 4 4 4 4 4 4 4 4 4 4 4 4 4 
4 4 4 4 4 4 4 3 4 4 4 3 3 5 3 7 3 6 3 3 4 4 4 4 4 4 4 4 4 3 6 3 5 3 4 4 4 4 4 4 4 4 4 4 4 4 4 4 4 4 4 4 4 4 4 4 4 4 4 4 4 4 4 4 4 4 4 4 4 4 4 4 4 4 4 4 4 4 4 4 4 4 4 4 4 4 4 4 4 4 4 4 4 4 4 4 4 4 4 4 
4 4 4 4 4 4 4 3 4 4 4 4 3 5 3 11 3 6 3 3 3 3 3 3 3 3 3 3 3 3 6 3 5 3 4 4 4 4 4 4 4 4 4 4 4 4 4 4 4 4 4 4 4 4 4 4 4 4 4 4 4 4 4 4 4 4 4 4 4 4 4 4 4 4 4 4 4 4 4 4 4 4 4 4 4 4 4 4 4 4 4 4 4 4 4 4 4 4 4 4 
4 4 4 4 4 4 4 3 4 4 4 4 4 5 3 10 3 6 6 6 6 6 6 6 6 6 6 6 6 6 6 3 5 3 4 4 4 4 4 4 4 4 4 4 4 4 4 4 4 4 4 4 4 4 4 4 4 4 4 4 4 4 4 4 4 4 4 4 4 4 4 4 4 4 4 4 4 4 4 4 4 4 4 4 4 4 4 4 4 4 4 4 4 4 4 4 4 4 4 4 
4 4 4 4 4 4 4 3 4 4 4 4 4 5 3 3 3 3 3 3 3 3 3 3 3 3 3 3 3 3 3 3 5 3 4 4 4 4 4 4 4 4 4 4 4 4 4 4 4 4 4 4 4 4 4 4 4 4 4 4 4 4 4 4 4 4 4 4 4 4 4 4 4 4 4 4 4 4 4 4 4 4 4 4 4 4 4 4 4 4 4 4 4 4 4 4 4 4 4 4 
4 4 4 4 4 4 4 3 4 4 4 4 4 5 5 5 5 5 5 5 5 5 5 5 5 5 5 5 5 5 5 5 5 3 4 4 4 4 4 4 4 4 4 4 4 4 4 4 4 4 4 4 4 4 4 4 4 4 4 4 4 4 4 4 4 4 4 4 4 4 4 4 4 4 4 4 4 4 4 4 4 4 4 4 4 4 4 4 4 4 4 4 4 4 4 4 4 4 4 4 
4 4 4 4 4 4 4 3 4 4 4 4 4 4 4 4 4 4 4 4 4 4 4 4 4 4 4 4 4 4 4 4 4 4 4 4 4 4 4 4 4 4 4 4 4 4 4 4 4 4 4 4 4 4 4 4 4 4 4 4 4 4 4 4 4 4 4 4 4 4 4 4 4 4 4 4 4 4 4 4 4 4 4 4 4 4 4 4 4 4 4 4 4 4 4 4 4 4 4 4 
4 4 4 4 4 4 4 3 3 3 3 3 3 3 3 3 3 3 3 3 3 3 3 3 3 3 3 3 3 3 3 3 3 3 3 3 3 3 3 3 3 3 3 3 3 3 3 3 3 3 3 3 3 3 3 3 3 3 3 3 3 3 3 3 3 3 3 3 3 4 4 4 4 4 4 4 4 4 4 4 4 4 4 4 4 4 4 4 4 4 4 4 4 4 4 4 4 4 4 4 
4 4 4 4 4 4 4 4 4 4 4 4 4 4 4 4 4 4 4 4 4 4 4 4 4 4 4 4 4 4 4 4 4 4 4 4 4 4 4 4 4 4 4 4 4 4 4 4 4 4 4 4 4 4 4 4 4 4 4 4 4 4 4 4 4 4 4 4 4 4 4 4 4 4 4 4 4 4 4 4 4 4 4 4 4 4 4 4 4 4 4 4 4 4 4 4 4 4 4 4 
4 4 4 4 4 4 4 4 4 4 4 4 4 4 4 4 4 4 4 4 4 4 4 4 4 4 4 4 4 4 4 4 4 4 4 4 4 4 4 4 4 4 4 4 4 4 4 4 4 4 4 4 4 4 4 4 4 4 4 4 4 4 4 4 4 4 4 4 4 4 4 4 4 4 4 4 4 4 4 4 4 4 4 4 4 4 4 4 4 4 4 4 4 4 4 4 4 4 4 4 
4 4 4 4 4 4 4 4 4 4 4 4 4 4 4 4 4 4 4 4 4 4 4 4 4 4 4 4 4 4 4 4 4 4 4 4 4 4 4 4 4 4 4 4 4 4 4 4 4 4 4 4 4 4 4 4 4 4 4 4 4 4 4 4 4 4 4 4 4 4 4 4 4 4 4 4 4 4 4 4 4 4 4 4 4 4 4 4 4 4 4 4 4 4 4 4 4 4 4 4 
4 4 4 4 4 4 4 4 4 4 4 4 4 4 4 4 4 4 4 4 4 4 4 4 4 4 4 4 4 4 4 4 4 4 4 4 4 4 4 4 4 4 4 4 4 4 4 4 4 4 4 4 4 4 4 4 4 4 4 4 4 4 4 4 4 4 4 4 4 4 4 4 4 4 4 4 4 4 4 4 4 4 4 4 4 4 4 4 4 4 4 4 4 4 4 4 4 4 4 4 
4 4 4 4 4 4 4 4 4 4 4 4 4 4 4 4 4 4 4 4 4 4 4 4 4 4 4 4 4 4 4 4 4 4 4 4 4 4 4 4 4 4 4 4 4 4 4 4 4 4 4 4 4 4 4 4 4 4 4 4 4 4 4 4 4 4 4 4 4 4 4 4 4 4 4 4 4 4 4 4 4 4 4 4 4 4 4 4 4 4 4 4 4 4 4 4 4 4 4 4 
